[]  [][][][][][][][][][][][][][][][][][][][][][][][][][][][][][][][][][][][][]
[]                                                                          []
[][][]  []  [][][]  [][][]  [][][][][][][][][][][]  []  [][][][][][][][][]  []
[]  []  []      []      []      []          []      []                  []  []
[]  []  []  []  [][][]  [][][]  []  [][][]  []  [][][][][][][]  [][][]  []  []
[]      []  []  []  []      []      []      []              []      []  []  []
[]  [][][]  []  []  []  []  [][][][][]  []  [][][][][]  []  [][][][][]  []  []
[]      []  []      []  []      []      []  []      []  []  []      []  []  []
[]  []  []  [][][][][]  [][][]  [][][]  [][][]  []  [][][]  []  []  []  []  []
[]  []  []          []      []      []  []      []      []  []  []      []  []
[]  []  [][][][][]  []  []  [][][]  [][][]  []  [][][]  []  []  [][][][][]  []
[]  []          []  []  []      []          []      []      []  []      []  []
[]  [][][][][]  []  [][][][][]  []  [][][][][][][][][]  [][][]  [][][]  []  []
[]      []      []      []      []      []          []      []      []  []  []
[][][]  []  [][][][][]  []  [][][][][][][]  [][][]  [][][]  [][][]  []  []  []
[]  []  []          []  []      []      []  []  []      []      []      []  []
[]  []  []  [][][]  []  []  [][][]  []  []  []  [][][]  []  []  []  [][][]  []
[]  []  []      []  []  []  []      []  []      []      []  []  []      []  []
[]  []  []  []  []  []  [][][]  [][][]  []  [][][]  []  []  []  [][][][][]  []
[]  []  []  []  []  []      []      []  []  []      []  []  []      []      []
[]  []  [][][]  []  [][][]  []  []  []  [][][]  []  []  []  [][][]  []  [][][]
[]      []      []      []  []  []  []          []  []  []      []  []  []  []
[][][][][]  [][][][][]  []  [][][]  []  [][][][][]  []  [][][]  []  []  []  []
[]          []      []  []      []  []      []      []      []  []  []      []
[]  [][][][][]  []  []  [][][]  []  []  []  []  []  [][][]  []  []  [][][]  []
[]      []      []      []      []  []  []  []  []      []  []  []          []
[]  [][][]  []  [][][][][]  [][][]  []  []  []  []  []  []  []  [][][][][]  []
[]  []      []  []          []      []  []  []  []  []  []  []          []  []
[]  []  [][][][][]  [][][][][]  [][][]  []  []  [][][]  []  [][][][][][][]  []
[]  []          []          []      []  []  []      []  []      []      []  []
[]  [][][][][]  [][][][][]  [][][]  []  []  [][][]  [][][][][]  []  []  []  []
[]  []          []      []  []      []  []      []  []      []  []  []      []
[]  []  [][][][][][][]  []  []  [][][]  []  [][][]  []  []  []  []  []  [][][]
[]  []      []          []      []      []  []      []  []  []  []  []      []
[]  [][][]  []  []  [][][][][][][][][][][]  []  [][][]  []  []  []  [][][]  []
[]      []  []  []  []                  []  []  []      []  []  []  []      []
[][][]  []  []  []  []  [][][][][][][]  [][][]  []  [][][]  [][][]  []  [][][]
[]      []      []  []              []          []      []          []      []
[][][][][][][][][][][][][][][][][][][][][][][][][][][][][][][][][][][][][]  []